o0o1o0o0o0o0o0f0f0f0o0o0o0o0o0o0o0f0f0f0
o1o1o0o4o0o1f0f0f0f0o0o0o0o4o0o1f0f0f0f0
o0o3o0o4o0o0o0f0f0f0o0o3o0o4o0o0o0f0f0f0
o0o0o0o0o0o0o0o0o0o0o0o0o0o0o0o0o0o0o0o0
w3w0w0o0o0o0o1o0o0o0w3w0w0o0o0o0o1o0o0o0
w0w0w0w2w0w0o0o0o0o0w0w0w0w2w0w0o0o0o0o0
w0w0g0o0g0g0o4o0o0o0w0w0g0o0g0g0o4o0o0o0
o0o0g0g0g0g0o4o0o0o0o0o0g0g0g0g0o4o0o0o0
o0o0g0g0g0o0o4o0o0o0o0o0g0g0g0o0o4o0o0o0
o0o0g0g0g0o0o4o0o0o0o0o0g0g0g0o0o4o0o0o0
o0o0o0o0o0o0o0f0f0f0o0o0o0o0o0o0o0f0f0f0
o0o0o0o4o0o1f0f0f0f0o0o0o0o4o0o1f0f0f0f0
o0o3o0o4o0o0o0f0f0f0o0o3o0o4o0o0o0f0f0f0
o0o0o0o0o0o0o0o0o0o0o0o0o0o0o0o0o0o0o0o0
w3w0w0o0o0o0o1o0o0o0w3w0w0o0o0o0o1o0o0o0
w0w0w0w2w0w0o0o0o0o0w0w0w0w2w0w0o0o0o0o0
w0w0g0o0g0g0o4o0o0o0w0w0g0o0g0g0o4o0o0o0
o0o0g0g0g0g0o4o0o0o0o0o0g0g0g0g0o4o0o0o0
o0o0g0g0g0o0o4o0o0o0o0o0g0g0g0o0o4o0o1o1
o0o0g0g0g0o0o4o0o0o0o0o0g0g0g0o0o4o0o1o0